*******************************************************
*...............*.......S........*....................*
*...............*................*....................*
*...............******************....................*
*.....................................................*
*.....................................................*
*.....................................................*
*.....................................................*
*......................*..............................*
*.....................................................*
*.....................YL..............................*
*******************************************************